docência - docency
sábio - date
altear - 	raise 
adiantado -	advanced
testa - 	forehead
teleférico -	ski lift
Ebulir	-	boil
Sussuro - 	swish sound
Sintaxe	-	syntax
Laurear	- 	praise, laud
promontório -	headland
Abóbada - 	dome
Abobado -	foolish, crazy
Espancar - 	spank, beat
Remissa - 	
Valente - 	
Pingo - 	
Ossada - 	
basear-se -	to be based on
babá - 		nanny, nursemaid
Baba - 		drool, slobber
Manutenção
Tartaruga -	turtle
Lebre -		hare, rabbit
à mercê de - 	at the mercy of
ponto de ônibus - bus stop
parceria 	-	partnership, association 
Aparelho - device
Proibir, proibido - prohibit, prohibited
Oleaginosas - 	oily, greasy, oleaginous
Julgado - territory, borough or municipality under the jurisdiction of a judge
Ácido Graxo - fatty acid
Poupar - to save
Queixa - complaint
Não caia nisso! - "Don't fall into that"
Lombada - range of hills, mountain range, rump; speed bump
Barulho - noise
Trava - bolt, cleat
Percurso - arrowroute, passage, course,  trajectory
Seta - arrow
Fatura - invoice
Afugentar - scare off
lâmpada - bulb
Painel - painting
morna - lukewarm
pastilha - pill
Tampa - lid, top, cover
Vazamento - leakage
Mangueira - mango tree, hose
Marrom - brown
Arlequinada - farce
Coringa - joker (cards)
Atingir - hit, strike
abatimento - cut, cutting down
Defasagem - difference, gap, phase, displacement
Patamar - landing
Constatar - verify, take note of
à espreita - on the prowl, lookout
Colchão - mattress
avulso - separate, distinct
plugue - electrical plug
pino - tack
quesito - aspect
destaque - highlight, focus
veredito - verdict 
razoável - reasonable 
testado - tested 
quantia - amount 
indenização - compensation , indemnity
Alegar - to allege
aquecedor - heater
esgoto - sewage
desempregado - unemployed
fornecedor - supplier 
endividamento  - debt
travamento - paper jam, computer crash
esticar - stretch out, lengthen, dilate
Demitido - dismissed
verba - budget, funds
rescisório - termination
despesa  - expenditure 









